		species	
Agalinis_acuta	"Agalinis_acuta"
Agalinis_aphylla	"Agalinis_aphylla"
Agalinis_auriculata	"Agalinis_auriculata"
Agalinis_calycina	"Agalinis_calycina"
Agalinis_divaricata	"Agalinis_divaricata"
Agalinis_edwardsiana	"Agalinis_edwardsiana"
Agalinis_fasciculata	"Agalinis_fasciculata"
Agalinis_filicaulis	"Agalinis_filicaulis"
Agalinis_gattingeri	"Agalinis_gattingeri"
Agalinis_harperi	"Agalinis_harperi"
Agalinis_heterophylla	"Agalinis_heterophylla"
Agalinis_homalantha	"Agalinis_homalantha"
Agalinis_laxa	"Agalinis_laxa"
Agalinis_linifolia	"Agalinis_linifolia"
Agalinis_maritima	"Agalinis_maritima"
Agalinis_navasotensis	"Agalinis_navasotensis"
Agalinis_obtusifolia	"Agalinis_obtusifolia"
Agalinis_oligophylla	"Agalinis_oligophylla"
Agalinis_paupercula	"Agalinis_paupercula"
Agalinis_plukenetii	"Agalinis_plukenetii"
Agalinis_pulchella	"Agalinis_pulchella"
Agalinis_purpurea	"Agalinis_purpurea"
Agalinis_setacea	"Agalinis_setacea"
Agalinis_skinneriana	"Agalinis_skinneriana"
Agalinis_strictifolia	"Agalinis_strictifolia"
Agalinis_tenuifolia	"Agalinis_tenuifolia"
Agalinis_viridis	"Agalinis_viridis"
Aureolaria_pedicularia	"Aureolaria_pedicularia"
Brachystigma_wrightii	"Brachystigma_wrightii"
Dasistoma_macrophylla	"Dasistoma_macrophylla"
